6x19
#  ###
   ###
#  ###
#
#  ###
#  # #
#  ###
#
    #
## ###
##  #

######

##  ##
#    #

#    #
##  ##